{
  "map": {
    "tiles":[
      "0000000000000000000000000000000000000000000000000000000000000000000000",
      "0111111111111111111111111111111111111111111111111111111111111111111110",
      "0101111100000111110000011111000001111100000111110000011111000001111110",
      "0101010000000101000000010100000001010000000101000000010100000001010010",
      "0100011000000001100000000110000000011000000001100000000110000000011010",
      "0100110000000011000000001100000000110000000011000000001100000000110010",
      "0100010100000001010000000101000000010100000001010000000101000000010110",
      "0101111100000111110000011111000001111100000111110000011111000001111110",
      "0101010000000101000000010100000001010000000101000000010100000001010010",
      "0100011000000001100000000110000000011000000001100000000110000000011010",
      "0100110000000011000000001100000000110000000011000000001100000000110010",
      "0100010100000001010000000101000000010100000001010000000101000000010110",
      "0101111100000111110000011111000001111100000111110000011111000001111110",
      "0101010000000101000000010100000001010000000101000000010100000001010010",
      "0100011000000001100000000110000000011000000001100000000110000000011010",
      "0100110000000011000000001100000000110000000011000000001100000000110010",
      "0100010100000001010000000101000000010100000001010000000101000000010110",
      "0101111100000111110000011111000001111100000111110000011111000001111110",
      "0101010000000101000000010100000001010000000101000000010100000001010010",
      "0100011000000001100000000110000000011000000001100000000110000000011010",
      "0100110000000011000000001100000000110000000011000000001100000000110010",
      "0100010100000001010000000101000000010100000001010000000101000000010110",
      "0101111100000111110000011111000001111100000111110000011111000001111110",
      "0101010000000101000000010100000001010000000101000000010100000001010010",
      "0100011000000001100000000110000000011000000001100000000110000000011010",
      "0100110000000011000000001100000000110000000011000000001100000000110010",
      "0100010100000001010000000101000000010100000001010000000101000000010110",
      "0101111100000111110000011111000001111100000111110000011111000001111110",
      "0101010000000101000000010100000001010000000101000000010100000001010010",
      "0100011000000001100000000110000000011000000001100000000110000000011010",
      "0100110000000011000000001100000000110000000011000000001100000000110010",
      "0100010100000001010000000101000000010100000001010000000101000000010110",
      "0101111100000111110000011111000001111100000111110000011111000001111110",
      "0101010000000101000000010100000001010000000101000000010100000001010010",
      "0100011000000001100000000110000000011000000001100000000110000000011010",
      "0100110000000011000000001100000000110000000011000000001100000000110010",
      "0100010100000001010000000101000000010100000001010000000101000000010110",
      "0101111100000111110000011111000001111100000111110000011111000001111110",
      "0101010000000101000000010100000001010000000101000000010100000001010010",
      "0100011000000001100000000110000000011000000001100000000110000000011010",
      "0100110000000011000000001100000000110000000011000000001100000000110010",
      "0100010100000001010000000101000000010100000001010000000101000000010110",
      "0101111100000111110000011111000001111100000111110000011111000001111110",
      "0101010000000101000000010100000001010000000101000000010100000001010010",
      "0100011000000001100000000110000000011000000001100000000110000000011010",
      "0100110000000011000000001100000000110000000011000000001100000000110010",
      "0100010100000001010000000101000000010100000001010000000101000000010110",
      "0101111100000111110000011111000001111100000111110000011111000001111110",
      "0101010000000101000000010100000001010000000101000000010100000001010010",
      "0100011000000001100000000110000000011000000001100000000110000000011010",
      "0100110000000011000000001100000000110000000011000000001100000000110010",
      "0100010100000001010000000101000000010100000001010000000101000000010110",
      "0101111100000111110000011111000001111100000111110000011111000001111110",
      "0101010000000101000000010100000001010000000101000000010100000001010010",
      "0100011000000001100000000110000000011000000001100000000110000000011010",
      "0100110000000011000000001100000000110000000011000000001100000000110010",
      "0100010100000001010000000101000000010100000001010000000101000000010110",
      "0101111100000111110000011111000001111100000111110000011111000001111110",
      "0111111111111111111111111111111111111111111111111111111111111111111110",
      "0000000000000000000000000000000000000000000000000000000000000000000000"
    ],
    "width": 70,
    "height": 60
  }
}